_A	Universal Quantification.  (_Ax P(x)) The proposition that is true iff all x's is the universe of discourse are such that P(x) is true.  (Upsidedown A).  See _E.
Absolute	Something that is independent of, and unconditioned by, anything external to itself.
Absolute	Something which holds in every possible case.
Abstract	That which exists in the mind rather than in the external world.
Absurd	In logic, that which is irrational or contradictory.
Accent	A stressed syllable or ictus.
Ad Hoc	Adopted for the purpose of saving from difficulty or confusion, but without any independant rationale.
Alliteration	Using the same consonant to start two or more stressed words or syllables in a phrase or verse line, or using a series of vowels to begin such words or syllables in sequence.
Allusion	A reference to a historical, mythic, or literary person, place, event, movement, etc.
Apostrophe	An address to a dead or absent person or personification as if he or she were present.
Assonance	The rhyming of a word with another in one or more of their accented vowels, but not in their consonants.
Asthetics	The branch of philosophy concerned with the study of beauty and art.
Agnosticism	The Belief that human beings do not have sufficient evidence to warrant either the affirmation fo the denial of a proposition.
Altruism	The belief that everyone should be concerned for the benefit and welfare of others.
Amoral	That which is neither moral nor immoral; outside the moral realm.
Anarchism	A political theory favoring the abolition of governments.
Anarchism	A political ideaology in which there is no central governing body.
Anarchy	Absence of government; the state of society where there is no law or supreme power.
Angst	A German term for an inner sense of despair or dread.
Anthropomorphism	The act of ascribing human characteristics to non-humans (especially to God).
Antinomy	A contradiction made up of a thesis and antithesis.
Antithesis	The contrast or opposite of the thesis statement.
Archetype	An original model, type, pattern, or paradigm.
Atheism	The lack of a belief in a supreme being or beings.
Autonomy	The state of being independent, self-determining, or free.
Axiom	A basic assumption of a theory
Axiomatic	Evident without proof or argument, "an axiomatic truth", "we hold these truths to be self-evedent".
Ballad	A popular song, often recited aloud, narrating a story, and passed down orally.
Being	That which exists, or is real (unchanging reality).
Blank Verse	Unrhyming iambic pentameter, also called heroic verse, a ten-syllable line and the usual rhythm of English dramatic and epic poetry.
C	Implies the preceeding set, as a subset of the set named by the proceeding term.  Example {2,3} C {2,3,5} where 2 and 3 (therefor {2,3}) are both contained in the set containing 2,3,5.  See Set Theory.
Cadence	The ametrical rhythm of natural speech.
Cogito	I think, therefore I am.  Otherwise stated, I think, ergo, I exist.
Conjunction	The proposition that is true if and only if both arguments are true (And)
Contingent	The state of being dependent upon something else for existence.
Corollary	A proposition that can be proved as a concequence of a theorem that has just been proved.
Cosmos	From the Greek word kosmos, meaning world or universe.
Couplet	A pair of successive rhyming lines, usually of the same length.
Cynicism	The belief that the entire point of human life is the satisfaction of our most basic natural needs, without any respect for social conventions.
Deism	Belief in a God who created the world, but does not intervene within it (God is transcendent, but not immanent).
Deus Ex Machina	Refers to the theatrical device whereby a supernatural agency is introduced to solve the dramatic situation; hence, any artificial, introduced, external, and ad hoc solution to a problem.
Deus Ex Machina	Divine Intervention  (Latin: God From The Machine)
Democracy	A system of government involving all, or a large part, of the people governed.
Determinism	The view that everything in the universe is controlled by previous conditions, and therefore could not be otherwise.
Determinism	The docritine that every event has a cause.
Disjunction	The proposition that is true unless both arguments are false. (Inclusive Or)
Doubt	From the Latin dubito, to be uncertain.
Dream	A phase of reality a subject falls into every so often, usually when they run out of energy, and returns from when sufficient conditions are met.  Usually they involve imagery, metephors, and events experienced upon the subject.
Dualism	In metaphysics, the view that reality consists of two fundamentally distinct entities.
Dualism	Any view that postulates two kinds of things in some domain is dualistic.
e	Implies the preceeding term, as a member of the set named by the proceeding term.  Example 2 e {2,3,5} where 2 is a member of the set containing 2,3,5.  See Set Theory.
_E	Existential Quantification.  (_Ex P(x)) The proposition that is true if and only if there exists at least one x such P(x) is true in the universe of discourse.  (Backwards E).  See _A.
Empiricism	The belief that the source of all knowledge is five sense experience. All knowledge of actually existing things is acquired through five sense experience. Contrasted with Rationalism.
Epic	An extended narrative poem with a heroic or superhuman protagonist engaged in an action of great significance in a vast setting (often including the underworld and engaging the gods).
Epicureansim	A hedonistic philosophy, founded by Epicurus, which stressed long-term and higher pleasure (i.e., pleasures of the mind over the bodily appetites).
Epistemology	The branch or field of philosophy concerned with the origin, nature, and limits of knowledge.
Essence	The nature or "whatness" of a thing. The qualities or attributes that make a thing what it is.
Ethics	The branch or field of philosophy concerned with moral values and human conduct.
Existentialism	A 20th-century philosophical movement; assumes that people are entirely free and thus responsible for what they make of themselves.
Existentialism	A modern approach (movement) to philosophy which rejects abstractions, and stresses concrete reality, especially individual human freedom, choice, subjectivity, and existence.
Exponentiation	A mathematical notation for the multiplication of a number by itself.  For example, x^3 = x * x * x.
Fallacy	Any error of reasoning.
Fatalism	The docritine that human action has no influence on events.  Fatalism is often confused with Determinism.
Fate	The belief that every single aspect of every single thing that ever happens is all pre-ordained and will happen no matter what you do, and you have absolutly no choice or free will in your actions. See Fatalism, Determinism.
Fideism	The view that there is no way (and often no need) to justify one's beliefs (usually religious belief). It is usually asserted that faith alone is sufficient.
Finite	Having specific boundaries, limitations, or an end.
Foundationalism	In epistemology, the belief that all knowledge is based upon first principles (foundational truths) which provide justification for all other beliefs. Some would argue that these foundational truths are themselves not subject to any proof.
Free Verse	Rhythmical but non-metrical, non-rhyming lines.
Haiku	Japanese poem of three unrhyming lines in 5, 7, and 5 syllables.
Harem	A group of females (often slaves).
Hedonism	The ethical viewpoint which asserts that pleasure is the summum bonum (greatest good). It is often asserted that mankind is a pleasure-seeking, pain-avoiding animal.
Humanism	The view that "mankind is the measure of all things." Something's value or significance is measured by its relationship to mankind.
Idealism	The metaphysical view that all reality consists of mind and/or ideas. Contrasted with Materialism.
Iff	If and only if.
Iff	Biconditional proposition.
Immanent	The state of being present with something (e.g., God is immanent [present within the universe]).
Indeterminism	The view that at least some events, especially the human will and behavior, are free of causal determination.
Indubitable	Beyond all doubt; absolutely or unquestionably true.
Infinite	Without boundaries, limitations, or an end.
Intuition	The faculty by which truth is immediately grasped, separate from five sense experience or reason.
Lemma	A simple theorem used to prove other theorems.
Limerick	A fixed verse form rhyming aabba, where a-lines have five feet and the b-lines three feet, and where the first and last lines end with the same word.
Logarithm	The inverse operation of exponentiation.  loga(x) = a^x.
Logarithm	A bottery thingie.
Logic	The study of the principles of correct thinking. The science that evaluates thinking and argumentation.
Lyric	Short poem in which the poet, the poet's persona, or a speaker expresses personal feelings, and often addressed to the reader.
Materialsim	The metaphysical view that all reality consists of material or physical entities with their physical properties. Contrasted with Idealism.
Metaphor	A comparison that is made literally.
Metaphysics	The branch or field of philosophy concerned with the ultimate nature, structure, and characteristics of reality. A narrow usage of the term refers to the study of that which lies beyond the physical realm (i.e., the supernatural realm).
Metre	The rhythm of verse, reduceable to one of four kinds, accentual, syllabic, accentual-syllabic, and quantitative.
Monism	The metaphysical view that all reality is one. Idealism and Materialism are examples of monism.
Mu	Nothing.
Naturalism	The belief that physical nature is the only reality. The philosophy of naturalism is characterized by Monism, antisupernaturalism, scientism, and Humanism.
Nihilism	A revolutionary doctrine that advocates destruction of the social system for its own sake.
Nihilism	The doctrine that nothing can be known; scepticism as to all knowledge and all reality.
Nihilism	The view that there is no meaning, purpose, significance, or value in the universe.
Noetic	Pertaining to reason, knowledge, and the intellect.
Nonsensical	Words or language having no meaning or conveying no intelligible ideas.
Null Set	The Set Containing No Members.  It is said that This set is a proper subset of all sets.  See Empty Set
Ode	A poem of high seriousness with irregular stanzaic forms.
Oxymoron	A figure of speech which is apparently self contradictory.
Pantheism	A world view that makes God identical with the world; "All is God and God is all." God is wholly Immanent, and therefore not transcendent.
Personification	An anthropomorphic figure of speech where the poet describes an abstraction, a thing, or a non-human form as if it were a person.
Philosophy	Any personal belief about how to live or how to deal with a situation.
Philosophy	The rational investigation of questions about existence and knowledge and ethics.
Pluralism	The metaphysical view that ultimate reality consists of many things. Contrasted with Monism.
Profusely	With great zeal.
Profusely	In an abundant manner.
Proof	A demonstration that a theorem is true.
Pragmatism	An American philosophy which makes workability and practical consequences the test for truth.
Proposition	A statement that is true or false.
Quatrain	A four-line stanza, rhyming abac, abcb, aabb, abab, abba, or aaba.
Rationalism	Broadly speaking, the epistemological view that stresses reason as the test of truth. In a strict sense, the belief that at least some knowledge is acquired independent of sense experience. Contrasted with Empiricism.
Realism	The belief in objective existence, often relative to some type of entity.
Realism	The belief that the essences of things possess objective reality.
Recursion	See Recursion.
Refrain	One or more lines repeated before or after the stanzas of a poem.
Relativism	The belief that no absolutes exist (in truth and/or ethics). Truth and morality vary from person to person, time to time, circumstance to circumstance.
Rhyme	Normally end-rhyme, that is, lines of verse characterized by the consonance of terminal words or syllables.
Sequence	An ordered Set.  See Set Theory
Set	A collection of distinct objects.  See Set Theory.
Skepticism	Systematic doubt.
Skepticism	To deny that true knowledge is attainable.
Solipsism	"I myself only exist." The only reality that exists is one's self.
Stanza	A group of verses separated from other such groups in a poem and often sharing a common rhyme scheme.
Substance	A thing's underlying essence; that which makes a thing what it is.
Tautology	A statement that is necessarily true.
Theism	The world view that affirms the existence of an infinite, personal God, who is the transcendent creator, and immanent sustainer of the world.
Theorem	An assertion that can be shown to be true.
Tone	The poet's attitude to the poem's subject as the reader interprets that, sometimes through the tone of the persona or speaker (who may feel quite differently).
Truth Value	A value of either true or false (exclusively)
Transcendent	Beyond, or distinct from, the time/space world.
Verse	As a mass noun, poetry in general (but in a non-judgmental sense).
Geek	See transistor.
transistor	See Geek.
